____________________________
|     A              A     |
|     A              A     |
|                    A     |
|     A     AAAAAAAAAAAAAA |
|     A       A            |
|     A       A            |
|     A       AAAAAA       |
|     A       A            |
|     A       A         AAA|
|                          |
|AAAAAA  AAAAAAAAAAAAA     |
|                   A      |
|AAAAAAA            A      |
|AAAAAAA                   |
|AAAAAAAAAAAAAAAAAAAA  O   |
____________________________