____________________________
|AAAAAAAAAAAAAAAAAAAAAAAAAA|
|AAAAAAAAAAAAAAAAAAAA  U  A|
|AAAAAAAAAAAAAAAAAAAA     A|
|A    AA      AAAAAAA     A|
|A    AA      A           A|
|A    AA      A           A|
|A    AA      AAAAAA      A|
|A    AA      A           A|
|A    AA      A         AAA|
|A                        A|
|A                       OA|
|A                        A|
|AAAAAAAAAAAAAAAAAAAAAAAAAA|
|AAAAAAAAAAAAAAAAAAAAAAAAAA|
|AAAAAAAAAAAAAAAAAAAAAAAAAA|
____________________________