____________________________
|AAAAAAAAAAAAAAAAAAAA  U  A|
|AAAAAAAAAAAAAAAAAAAA     A|
|AAAAAAAAAAAAAAAAAAAA     A|
|A    AA      AAAAAAA     A|
|A    AA      A           A|
|A    AA      A           A|
|A    AA      AAAAAA      A|
|A    AA      A           A|
|A    AA      A         AAA|
|A                         |
|A                        O|
|A                         |
|AAAAAAAAAAAAAAAAAAAAAAAAAA|
|AAAAAAAAAAAAAAAAAAAAAAAAAA|
|AAAAAAAAAAAAAAAAAAAAAAAAAA|
____________________________