____________________________
|AAAAAAAAAAAAAAAAAAAAAAAAAA|
|A                        A|
|A                        A|
|A                        A|
|A                        A|
|A                        A|
|A                        A|
|A                        A|
|A                        A|
|                         A|
|U                        A|
|                         A|
|A                        A|
|A                        A|
|AAAAAAAAAAAAAAAAAAAAAAAAAA|
____________________________