____________________________
|AAAAAAAAAAAAAAAAAAAAAAAAAA|
|A                        A|
|A                        A|
|A                        A|
|A           T            A|
|A                        A|
|A                        A|
|A                        A|
|A                        A|
|A                        A|
|AU                       A|
|A                        A|
|A                        A|
|A                        A|
|AAAAAAAAAAAAAAAAAAAAAAAAAA|
____________________________