____________________________
|AAAAAAAAAAAAAAAAAAAAAAAAAA|
|A                         |
|A                         |
|A                         |
|A                         |
|A                         |
|A                         |
|A                         |
|A                         |
|                          |
|U                         |
|                          |
|                          |
|                          |
|                          |
____________________________